projectName,pullRequestId,sourceFiles,defs,uses,diffs,totalPartitions,nonTrivialPartitions,trivialPartitions
Activiti/Activiti,595,1,281,430,2,2,0,2
Activiti/Activiti,599,1,23,32,3,3,0,3
Activiti/Activiti,600,1,41,95,1,1,0,1
Activiti/Activiti,601,3,109,211,7,4,1,3
Activiti/Activiti,603,1,14,17,2,1,1,0
Activiti/Activiti,608,1,190,468,1,1,0,1
Activiti/Activiti,609,2,99,206,6,3,0,3
Activiti/Activiti,610,64,4809,8858,88,88,0,88
Activiti/Activiti,611,1,14,20,1,1,0,1
Activiti/Activiti,612,1,23,37,1,1,0,1
Activiti/Activiti,613,3,102,251,12,8,1,7
Activiti/Activiti,614,6,650,1206,5,5,0,5
Activiti/Activiti,615,4,156,391,16,11,2,9
Activiti/Activiti,616,4,155,388,16,11,2,9
Activiti/Activiti,618,3,444,904,13,11,1,10
Activiti/Activiti,620,2,35,65,2,2,0,2
Activiti/Activiti,624,15,1269,2526,53,27,6,21
Activiti/Activiti,629,2,85,131,3,2,1,1
Activiti/Activiti,632,1,24,49,4,1,1,0
Activiti/Activiti,633,1,50,162,1,1,0,1
Activiti/Activiti,634,1,485,871,2,2,0,2
Activiti/Activiti,635,8,1758,3149,17,13,2,11
Activiti/Activiti,527,9,723,1679,42,23,3,20
Activiti/Activiti,528,16,787,1018,65,32,4,28
Activiti/Activiti,529,1,5,4,0,0,0,0
Activiti/Activiti,531,3,310,462,8,6,1,5
Activiti/Activiti,533,3,68,82,4,2,1,1
Activiti/Activiti,534,9,325,448,51,26,3,23
Activiti/Activiti,540,3,125,255,4,4,0,4
Activiti/Activiti,541,3,45,64,3,3,0,3
Activiti/Activiti,545,1,12,19,2,1,1,0
Activiti/Activiti,546,4,385,791,25,13,2,11
Activiti/Activiti,547,2,548,959,3,2,0,2
Activiti/Activiti,548,1,37,66,1,1,0,1
Activiti/Activiti,550,2,72,319,3,2,0,2
Activiti/Activiti,554,1,199,577,1,1,0,1
Activiti/Activiti,555,6,168,318,26,13,2,11
Activiti/Activiti,556,8,228,382,35,24,4,20
Activiti/Activiti,557,1,38,101,1,1,0,1
Activiti/Activiti,558,1,457,848,1,1,0,1
Activiti/Activiti,560,1,199,577,1,1,0,1
Activiti/Activiti,563,3,215,201,25,19,1,18
Activiti/Activiti,565,1,28,39,3,3,0,3
Activiti/Activiti,566,2,227,658,2,2,0,2
Activiti/Activiti,567,5,464,890,37,21,2,19
Activiti/Activiti,568,1,96,304,3,1,0,1
Activiti/Activiti,569,1,77,96,3,3,0,3
Activiti/Activiti,570,6,274,677,23,7,1,6
Activiti/Activiti,572,1,22,47,1,1,0,1
Activiti/Activiti,573,4,388,746,13,9,1,8
Activiti/Activiti,574,6,205,333,9,3,2,1
Activiti/Activiti,575,2,105,231,17,10,0,10
Activiti/Activiti,576,2,110,239,9,6,1,5
Activiti/Activiti,577,3,567,1029,3,3,0,3
Activiti/Activiti,578,4,589,1206,11,7,0,7
Activiti/Activiti,580,1,4,1,2,1,0,1
Activiti/Activiti,584,2,59,64,16,4,1,3
Activiti/Activiti,588,4,153,217,18,5,1,4
Activiti/Activiti,590,1,45,1,1,1,0,1
Activiti/Activiti,591,7,1146,2480,38,22,3,19
Activiti/Activiti,593,7,658,997,28,13,1,12
Activiti/Activiti,542,3,135,232,36,13,2,11
Activiti/Activiti,594,2,35,65,2,2,0,2
airlift/airlift,179,1,47,44,1,1,0,1
airlift/airlift,259,10,170,296,83,23,1,22
airlift/airlift,167,1,6,4,0,0,0,0
airlift/airlift,168,1,109,238,2,2,0,2
airlift/airlift,170,2,22,26,5,3,1,2
airlift/airlift,174,3,83,87,3,3,0,3
airlift/airlift,266,4,136,360,34,11,2,9
airlift/airlift,268,2,41,72,5,4,0,4
airlift/airlift,275,2,158,459,6,2,1,1
airlift/airlift,277,1,113,367,1,1,0,1
airlift/airlift,284,1,32,60,2,2,0,2
airlift/airlift,288,3,155,292,9,2,1,1
airlift/airlift,289,1,72,140,2,2,0,2
airlift/airlift,294,1,13,14,2,2,0,2
airlift/airlift,295,1,4,3,4,4,0,4
airlift/airlift,296,1,13,12,2,2,0,2
airlift/airlift,297,1,12,12,7,5,1,4
airlift/airlift,300,2,86,82,2,2,0,2
airlift/airlift,301,1,57,100,1,1,0,1
airlift/airlift,302,2,41,62,3,2,1,1
airlift/airlift,307,4,229,607,9,3,2,1
airlift/airlift,311,1,45,66,3,2,1,1
airlift/airlift,319,2,129,389,2,2,0,2
airlift/airlift,323,1,73,108,18,3,1,2
airlift/airlift,326,1,62,73,3,1,0,1
airlift/airlift,328,1,12,31,2,2,0,2
airlift/airlift,329,1,65,77,8,1,1,0
airlift/airlift,331,7,64,79,31,11,2,9
airlift/airlift,332,1,54,70,1,1,0,1
airlift/airlift,183,2,17,12,4,4,0,4
airlift/airlift,185,1,79,108,1,1,0,1
airlift/airlift,189,2,130,335,15,6,1,5
airlift/airlift,190,1,79,112,1,1,0,1
airlift/airlift,191,16,415,1126,153,28,2,26
airlift/airlift,193,2,54,73,16,9,2,7
airlift/airlift,195,1,34,48,9,6,2,4
airlift/airlift,203,3,75,64,33,17,3,14
airlift/airlift,204,4,168,384,59,16,3,13
airlift/airlift,205,1,26,25,1,1,0,1
airlift/airlift,206,3,149,271,40,9,3,6
airlift/airlift,207,1,26,61,6,2,0,2
airlift/airlift,208,1,49,59,1,1,0,1
airlift/airlift,212,1,40,29,5,3,0,3
airlift/airlift,213,7,267,402,84,64,3,61
airlift/airlift,214,1,19,20,10,10,0,10
airlift/airlift,215,1,40,83,1,1,0,1
airlift/airlift,216,1,15,15,7,3,1,2
airlift/airlift,218,1,28,39,1,1,0,1
airlift/airlift,219,3,130,164,9,4,1,3
airlift/airlift,222,1,13,11,6,2,1,1
airlift/airlift,224,7,70,90,48,15,1,14
airlift/airlift,225,4,115,134,28,25,0,25
airlift/airlift,229,1,3,0,3,3,0,3
airlift/airlift,232,1,51,74,1,1,0,1
airlift/airlift,235,1,6,6,4,2,1,1
airlift/airlift,236,1,49,72,1,1,0,1
airlift/airlift,237,2,71,96,17,12,1,11
airlift/airlift,238,2,75,122,18,15,1,14
airlift/airlift,241,1,13,16,7,2,1,1
airlift/airlift,244,5,187,358,20,10,1,9
airlift/airlift,247,1,14,11,2,2,0,2
airlift/airlift,250,1,26,48,1,1,0,1
airlift/airlift,254,3,83,115,8,7,1,6
amplab/tachyon,899,4,295,634,7,7,0,7
amplab/tachyon,1002,3,87,160,24,7,1,6
amplab/tachyon,1003,10,595,1192,59,24,1,23
amplab/tachyon,1006,2,17,33,4,2,1,1
amplab/tachyon,1007,1,72,102,1,1,0,1
amplab/tachyon,1008,1,103,139,4,3,1,2
amplab/tachyon,1009,1,41,76,0,0,0,0
amplab/tachyon,1012,1,128,209,1,1,0,1
amplab/tachyon,1013,1,17,28,1,1,0,1
amplab/tachyon,1014,2,144,216,3,2,1,1
amplab/tachyon,1015,1,51,138,1,1,0,1
amplab/tachyon,1018,10,359,677,24,13,1,12
amplab/tachyon,1021,10,361,678,24,13,1,12
amplab/tachyon,1022,4,292,548,36,10,1,9
amplab/tachyon,1023,2,24,44,2,2,0,2
amplab/tachyon,1024,2,54,0,9,9,0,9
amplab/tachyon,1025,2,107,239,5,1,1,0
amplab/tachyon,1026,8,453,755,29,9,1,8
amplab/tachyon,1027,8,78,245,22,10,1,9
amplab/tachyon,1029,1,55,114,2,2,0,2
amplab/tachyon,1030,10,117,341,32,13,1,12
amplab/tachyon,1031,1,9,12,7,2,1,1
amplab/tachyon,900,1,197,320,3,2,1,1
amplab/tachyon,902,14,795,2334,64,61,0,61
amplab/tachyon,904,3,157,339,15,11,1,10
amplab/tachyon,906,3,185,366,30,12,3,9
amplab/tachyon,907,4,283,622,19,15,1,14
amplab/tachyon,909,2,13,26,11,9,0,9
amplab/tachyon,912,2,153,318,2,1,1,0
amplab/tachyon,914,1,58,75,1,1,0,1
amplab/tachyon,917,4,115,255,18,5,3,2
amplab/tachyon,918,3,332,824,11,2,1,1
amplab/tachyon,921,1,13,27,2,2,0,2
amplab/tachyon,923,1,32,67,1,1,0,1
amplab/tachyon,930,3,96,38,4,4,0,4
amplab/tachyon,934,4,32,44,7,7,0,7
amplab/tachyon,935,1,40,174,1,1,0,1
amplab/tachyon,940,3,40,110,15,9,2,7
amplab/tachyon,945,1,70,217,1,1,0,1
amplab/tachyon,947,1,69,172,1,1,0,1
amplab/tachyon,949,3,88,188,16,7,1,6
amplab/tachyon,950,15,604,1340,27,23,1,22
amplab/tachyon,952,1,26,49,6,2,1,1
amplab/tachyon,954,5,385,1004,11,8,0,8
amplab/tachyon,956,1,74,141,3,1,0,1
amplab/tachyon,957,5,380,987,13,11,0,11
amplab/tachyon,958,3,64,125,19,11,3,8
amplab/tachyon,961,1,32,102,3,1,1,0
amplab/tachyon,962,17,284,483,90,36,2,34
amplab/tachyon,965,1,26,52,2,1,0,1
amplab/tachyon,969,4,75,102,20,16,2,14
amplab/tachyon,970,4,193,398,14,5,2,3
amplab/tachyon,972,1,26,52,2,1,0,1
amplab/tachyon,973,25,531,991,40,36,1,35
amplab/tachyon,977,2,110,339,8,7,0,7
amplab/tachyon,984,4,77,196,11,2,1,1
amplab/tachyon,985,1,41,125,2,2,0,2
amplab/tachyon,986,3,60,121,18,8,1,7
amplab/tachyon,990,13,509,883,30,19,1,18
amplab/tachyon,993,1,39,118,5,1,1,0
amplab/tachyon,995,7,211,438,77,16,2,14
amplab/tachyon,996,7,207,435,0,0,0,0
amplab/tachyon,997,2,121,275,7,3,1,2
Atmosphere/atmosphere,1282,1,28,27,1,1,0,1
Atmosphere/atmosphere,1357,1,7,11,1,1,0,1
Atmosphere/atmosphere,1361,1,12,13,2,1,0,1
Atmosphere/atmosphere,1432,2,136,302,10,7,1,6
Atmosphere/atmosphere,1440,5,60,99,29,10,2,8
Atmosphere/atmosphere,1454,4,715,1705,11,4,1,3
Atmosphere/atmosphere,1466,2,181,414,3,2,1,1
Atmosphere/atmosphere,1490,1,58,98,4,4,0,4
Atmosphere/atmosphere,1500,1,84,150,2,1,1,0
Atmosphere/atmosphere,1514,2,45,93,7,4,1,3
Atmosphere/atmosphere,1515,1,27,40,10,2,1,1
Atmosphere/atmosphere,1554,1,155,476,6,2,2,0
Atmosphere/atmosphere,1567,1,102,170,1,1,0,1
Atmosphere/atmosphere,1583,1,59,101,2,1,0,1
Atmosphere/atmosphere,1593,1,480,967,1,1,0,1
Atmosphere/atmosphere,1600,1,180,396,9,5,1,4
Atmosphere/atmosphere,1601,1,180,396,9,5,1,4
Atmosphere/atmosphere,1610,2,69,91,17,4,2,2
Atmosphere/atmosphere,1641,1,125,262,6,6,0,6
Atmosphere/atmosphere,1660,1,486,975,1,1,0,1
Atmosphere/atmosphere,1671,2,572,1451,2,2,0,2
Atmosphere/atmosphere,1684,1,16,12,4,4,0,4
Atmosphere/atmosphere,1689,1,18,31,4,1,1,0
Atmosphere/atmosphere,1693,1,112,288,2,2,0,2
Atmosphere/atmosphere,1696,12,2016,4876,44,27,3,24
Atmosphere/atmosphere,1697,4,721,1621,9,7,1,6
Atmosphere/atmosphere,1702,1,180,396,1,1,0,1
Atmosphere/atmosphere,1708,1,201,584,2,1,0,1
Atmosphere/atmosphere,1721,1,40,72,1,1,0,1
Atmosphere/atmosphere,1727,1,556,1423,3,2,0,2
Atmosphere/atmosphere,1741,1,40,76,3,2,1,1
Atmosphere/atmosphere,1744,2,239,533,6,5,1,4
Atmosphere/atmosphere,1746,1,369,1088,1,1,0,1
Atmosphere/atmosphere,1748,1,496,1005,8,4,2,2
Atmosphere/atmosphere,1750,2,80,137,11,9,1,8
Atmosphere/atmosphere,1761,1,182,406,2,2,0,2
Atmosphere/atmosphere,1774,1,32,51,3,2,1,1
Atmosphere/atmosphere,1776,2,141,52,2,1,1,0
Atmosphere/atmosphere,1787,1,28,18,2,1,0,1
Atmosphere/atmosphere,1790,1,37,80,2,1,1,0
Atmosphere/atmosphere,1802,1,100,305,1,1,0,1
Atmosphere/atmosphere,1805,1,83,172,1,1,0,1
Atmosphere/atmosphere,1808,1,194,467,1,1,0,1
Atmosphere/atmosphere,1818,1,34,53,1,1,0,1
Atmosphere/atmosphere,1819,1,15,23,1,1,0,1
Atmosphere/atmosphere,1823,1,598,1536,0,0,0,0
Atmosphere/atmosphere,1847,1,85,147,6,1,1,0
Atmosphere/atmosphere,1858,2,640,1596,2,2,0,2
Atmosphere/atmosphere,1859,1,613,1553,1,1,0,1
Atmosphere/atmosphere,1874,1,81,170,1,1,0,1
Atmosphere/atmosphere,1876,1,613,1553,1,1,0,1
Atmosphere/atmosphere,1877,2,722,1894,18,11,1,10
Atmosphere/atmosphere,1898,2,191,97,6,2,1,1
Atmosphere/atmosphere,1901,1,272,573,5,1,0,1
Atmosphere/atmosphere,1907,1,635,1593,4,1,1,0
Atmosphere/atmosphere,1930,1,17,28,3,3,0,3
Atmosphere/atmosphere,1935,1,74,193,1,1,0,1
Atmosphere/atmosphere,1962,1,27,40,1,1,0,1
Atmosphere/atmosphere,1964,1,28,43,5,1,1,0
Atmosphere/atmosphere,1995,1,111,294,5,3,1,2
Atmosphere/atmosphere,1607,10,630,1061,35,20,3,17
Atmosphere/atmosphere,1780,1,369,1088,3,1,1,0
Atmosphere/atmosphere,1970,1,569,1492,1,1,0,1
elastic/elasticsearch,11839,2,575,1145,2,2,0,2
elastic/elasticsearch,11765,1,35,58,1,1,0,1
elastic/elasticsearch,11768,1,93,202,8,2,0,2
elastic/elasticsearch,11769,2,465,1014,4,3,0,3
elastic/elasticsearch,11778,8,464,957,36,14,2,12
elastic/elasticsearch,11780,3,986,1566,9,4,2,2
elastic/elasticsearch,11790,1,461,877,2,1,1,0
elastic/elasticsearch,11793,2,267,730,5,5,0,5
elastic/elasticsearch,11795,1,292,694,5,5,0,5
elastic/elasticsearch,11796,70,2548,4614,171,162,2,160
elastic/elasticsearch,11804,2,122,357,0,0,0,0
elastic/elasticsearch,11805,2,156,432,8,6,1,5
elastic/elasticsearch,11807,3,315,694,13,8,2,6
elastic/elasticsearch,11810,2,80,118,10,4,2,2
elastic/elasticsearch,11815,1,3,0,2,2,0,2
elastic/elasticsearch,11817,6,147,297,34,15,2,13
elastic/elasticsearch,11818,17,649,1226,21,21,0,21
elastic/elasticsearch,11823,3,63,120,30,7,1,6
elastic/elasticsearch,11825,7,122,176,36,11,1,10
elastic/elasticsearch,11826,1,61,132,1,1,0,1
elastic/elasticsearch,11828,1,122,346,15,2,1,1
elastic/elasticsearch,11833,1,98,173,1,1,0,1
elastic/elasticsearch,11834,33,1066,2456,97,54,11,43
elastic/elasticsearch,11835,2,115,303,5,3,1,2
elastic/elasticsearch,11837,1,41,201,2,2,0,2
elastic/elasticsearch,11850,1,20,59,1,1,0,1
elastic/elasticsearch,11865,6,237,699,69,18,1,17
elastic/elasticsearch,11871,2,388,1232,10,1,1,0
elastic/elasticsearch,11884,2,30,36,8,3,1,2
elastic/elasticsearch,11885,6,345,862,39,16,1,15
elastic/elasticsearch,11886,4,685,1481,11,7,1,6
elastic/elasticsearch,11889,29,1064,2208,77,37,4,33
elastic/elasticsearch,11890,2,133,139,53,43,2,41
elastic/elasticsearch,11896,3,81,224,41,12,1,11
elastic/elasticsearch,11898,11,330,630,10,7,1,6
elastic/elasticsearch,11903,2,531,1144,18,9,1,8
elastic/elasticsearch,11909,1,29,70,1,1,0,1
elastic/elasticsearch,11911,1,82,162,1,1,0,1
elastic/elasticsearch,11915,33,2217,3984,113,51,8,43
elastic/elasticsearch,11918,6,226,441,12,8,1,7
elastic/elasticsearch,11925,1,235,461,1,1,0,1
elastic/elasticsearch,11928,1,10,17,1,1,0,1
elastic/elasticsearch,11929,1,86,138,1,1,0,1
elastic/elasticsearch,11933,4,949,1623,9,2,1,1
elastic/elasticsearch,11936,1,26,49,2,2,0,2
elastic/elasticsearch,11940,1,26,49,3,2,0,2
elastic/elasticsearch,11948,4,164,391,37,10,3,7
elastic/elasticsearch,11949,5,84,118,19,9,2,7
elastic/elasticsearch,11954,1,41,74,1,1,0,1
elastic/elasticsearch,11960,5,580,1248,21,6,1,5
elastic/elasticsearch,11963,2,184,484,13,7,1,6
elastic/elasticsearch,11965,1,286,711,1,1,0,1
elastic/elasticsearch,11969,5,231,547,51,14,1,13
elastic/elasticsearch,11972,4,734,1477,23,7,1,6
elastic/elasticsearch,11973,2,160,392,14,6,2,4
elastic/elasticsearch,11974,123,3589,8212,394,282,20,262
elastic/elasticsearch,11979,2,42,83,9,4,1,3
elastic/elasticsearch,11982,1,31,65,2,1,0,1
elastic/elasticsearch,11999,5,261,622,27,12,3,9
elastic/elasticsearch,12002,13,1290,2398,138,54,6,48
elastic/elasticsearch,12003,1,44,73,1,1,0,1
elastic/elasticsearch,12006,9,521,1205,40,13,1,12
elastic/elasticsearch,12008,5,344,737,64,11,1,10
facebook/presto,3086,2,82,368,2,2,0,2
facebook/presto,2992,4,168,247,46,13,4,9
facebook/presto,2995,1,44,49,1,1,0,1
facebook/presto,2997,3,234,430,6,6,0,6
facebook/presto,3000,1,43,66,3,2,1,1
facebook/presto,3001,2,162,256,7,2,1,1
facebook/presto,3011,1,13,10,3,3,0,3
facebook/presto,3013,2,34,40,3,3,0,3
facebook/presto,3014,1,11,5,16,9,0,9
facebook/presto,3028,2,22,34,4,4,0,4
facebook/presto,3031,1,150,316,1,1,0,1
facebook/presto,3034,2,24,39,5,5,0,5
facebook/presto,3039,3,381,573,6,5,1,4
facebook/presto,3040,4,26,28,18,12,3,9
facebook/presto,3045,8,246,441,21,9,5,4
facebook/presto,3048,1,40,62,1,1,0,1
facebook/presto,3050,5,215,341,14,10,3,7
facebook/presto,3053,16,214,203,109,51,6,45
facebook/presto,3055,1,13,8,2,2,0,2
facebook/presto,3058,4,51,70,0,0,0,0
facebook/presto,3059,1,49,82,1,1,0,1
facebook/presto,3063,2,19,30,7,6,1,5
facebook/presto,3064,1,67,121,3,1,1,0
facebook/presto,3065,2,191,149,4,4,0,4
facebook/presto,3069,1,30,49,1,1,0,1
facebook/presto,3072,1,50,104,4,2,1,1
facebook/presto,3078,14,437,1028,23,11,2,9
facebook/presto,3083,1,76,144,9,3,1,2
facebook/presto,3087,1,32,42,2,2,0,2
facebook/presto,3090,6,552,1057,15,5,1,4
facebook/presto,3091,2,191,149,2,2,0,2
facebook/presto,3097,2,213,510,37,8,2,6
facebook/presto,3101,1,152,155,2,2,0,2
facebook/presto,3102,2,73,162,6,6,0,6
facebook/presto,3111,1,108,184,1,1,0,1
facebook/presto,3112,1,108,184,1,1,0,1
facebook/presto,3113,2,147,269,1,1,0,1
facebook/presto,3116,1,60,90,1,1,0,1
facebook/presto,3120,3,177,496,10,9,1,8
facebook/presto,3121,1,61,123,4,1,1,0
facebook/presto,3123,1,92,327,3,3,0,3
facebook/presto,3124,1,151,315,2,2,0,2
facebook/presto,3128,2,49,80,3,3,0,3
facebook/presto,3130,1,36,47,7,4,1,3
facebook/presto,3131,4,124,220,9,6,0,6
facebook/presto,3136,1,198,442,10,4,1,3
facebook/presto,3137,2,114,219,6,1,1,0
facebook/presto,3142,2,143,321,8,8,0,8
facebook/presto,3143,6,210,287,40,9,1,8
facebook/presto,3148,10,608,567,27,22,2,20
facebook/presto,3149,1,412,1157,10,3,1,2
facebook/presto,3150,1,415,1160,16,2,1,1
facebook/presto,3166,1,92,218,0,0,0,0
facebook/presto,3172,3,45,87,10,6,1,5
facebook/presto,3176,1,26,38,1,1,0,1
facebook/presto,3181,2,117,174,12,7,1,6
facebook/presto,3188,1,158,292,2,2,0,2
facebook/presto,3190,2,167,301,6,2,0,2
facebook/presto,3192,1,297,1432,4,1,0,1
facebook/presto,3194,3,84,191,11,7,2,5
facebook/presto,3195,1,51,129,4,2,1,1
facebook/presto,3196,1,31,37,4,2,1,1
facebook/presto,3217,2,71,143,12,8,1,7
hibernate/hibernate-orm,905,6,903,3510,33,22,3,19
hibernate/hibernate-orm,935,2,86,250,6,6,0,6
hibernate/hibernate-orm,906,12,218,328,81,36,1,35
hibernate/hibernate-orm,908,1,14,21,2,2,0,2
hibernate/hibernate-orm,909,5,140,523,23,14,2,12
hibernate/hibernate-orm,911,13,662,981,58,37,4,33
hibernate/hibernate-orm,912,1,41,65,1,1,0,1
hibernate/hibernate-orm,913,3,579,1010,14,7,2,5
hibernate/hibernate-orm,914,2,68,100,2,2,0,2
hibernate/hibernate-orm,915,4,132,245,15,6,2,4
hibernate/hibernate-orm,916,3,48,32,15,8,1,7
hibernate/hibernate-orm,917,1,24,58,1,1,0,1
hibernate/hibernate-orm,919,36,961,1671,225,89,5,84
hibernate/hibernate-orm,921,3,92,265,17,6,1,5
hibernate/hibernate-orm,922,3,59,57,39,6,3,3
hibernate/hibernate-orm,923,36,962,1696,224,73,5,68
hibernate/hibernate-orm,924,10,952,1984,106,54,3,51
hibernate/hibernate-orm,925,3,92,265,17,6,1,5
hibernate/hibernate-orm,926,8,416,1175,46,20,3,17
hibernate/hibernate-orm,927,7,1017,412,24,11,2,9
hibernate/hibernate-orm,928,1,350,645,2,2,0,2
hibernate/hibernate-orm,929,4,131,409,13,9,0,9
hibernate/hibernate-orm,932,13,2724,4106,125,44,7,37
hibernate/hibernate-orm,933,11,465,776,64,36,4,32
hibernate/hibernate-orm,936,6,448,532,67,65,1,64
hibernate/hibernate-orm,939,1,107,54,106,56,0,56
hibernate/hibernate-orm,940,3,64,120,17,13,1,12
hibernate/hibernate-orm,941,5,0,0,5,5,0,5
hibernate/hibernate-orm,943,12,468,1597,68,24,2,22
hibernate/hibernate-orm,944,8,455,661,37,20,3,17
hibernate/hibernate-orm,945,2,42,56,11,9,1,8
hibernate/hibernate-orm,947,1,33,69,2,2,0,2
hibernate/hibernate-orm,948,3,132,189,10,2,1,1
hibernate/hibernate-orm,949,1,76,137,0,0,0,0
hibernate/hibernate-orm,951,5,421,1203,14,12,0,12
hibernate/hibernate-orm,952,1,93,186,1,1,0,1
hibernate/hibernate-orm,953,4,282,757,22,7,1,6
hibernate/hibernate-orm,955,1,129,494,16,5,1,4
hibernate/hibernate-orm,956,2,82,115,30,20,2,18
hibernate/hibernate-orm,957,1,47,45,2,1,1,0
hibernate/hibernate-orm,958,9,418,556,121,19,3,16
hibernate/hibernate-orm,962,8,2026,3915,30,13,2,11
hibernate/hibernate-orm,964,11,2586,3596,27,12,3,9
hibernate/hibernate-orm,965,2,425,737,12,6,0,6
hibernate/hibernate-orm,966,2,425,737,7,5,0,5
hibernate/hibernate-orm,967,2,129,145,17,2,1,1
hibernate/hibernate-orm,968,1,197,413,3,2,1,1
hibernate/hibernate-orm,969,1,197,413,3,2,1,1
hibernate/hibernate-orm,970,5,78,158,27,12,1,11
hibernate/hibernate-orm,971,6,144,515,31,10,2,8
hibernate/hibernate-orm,972,6,144,515,31,10,2,8
hibernate/hibernate-orm,975,2,98,175,16,8,1,7
hibernate/hibernate-orm,978,1,477,1194,2,2,0,2
hibernate/hibernate-orm,979,2,264,548,12,9,2,7
hibernate/hibernate-orm,980,1,21,28,1,1,0,1
hibernate/hibernate-orm,981,1,21,25,7,5,1,4
hibernate/hibernate-orm,984,5,733,1332,62,28,2,26
hibernate/hibernate-orm,987,1,83,128,2,2,0,2
hibernate/hibernate-orm,988,10,268,448,35,16,3,13
hibernate/hibernate-orm,989,1,83,128,2,2,0,2
hibernate/hibernate-orm,899,1,18,15,4,1,0,1
hibernate/hibernate-orm,900,2,31,39,5,5,0,5
hibernate/hibernate-orm,904,1,40,36,4,2,0,2
JetBrains/intellij-community,175,1,213,339,1,1,0,1
JetBrains/intellij-community,106,2,57,97,25,10,1,9
JetBrains/intellij-community,108,2,295,360,4,4,0,4
JetBrains/intellij-community,110,1,44,47,2,2,0,2
JetBrains/intellij-community,118,1,40,71,2,2,0,2
JetBrains/intellij-community,119,1,20,41,3,1,0,1
JetBrains/intellij-community,128,2,50,84,12,5,2,3
JetBrains/intellij-community,133,3,68,162,12,10,1,9
JetBrains/intellij-community,136,1,25,45,6,5,1,4
JetBrains/intellij-community,139,2,88,134,7,4,1,3
JetBrains/intellij-community,141,1,103,190,4,1,1,0
JetBrains/intellij-community,146,3,249,407,17,10,2,8
JetBrains/intellij-community,147,2,222,379,31,15,4,11
JetBrains/intellij-community,149,2,501,817,3,3,0,3
JetBrains/intellij-community,151,2,24,49,5,4,1,3
JetBrains/intellij-community,156,2,176,382,8,4,3,1
JetBrains/intellij-community,157,1,60,155,1,1,0,1
JetBrains/intellij-community,158,3,342,692,11,5,1,4
JetBrains/intellij-community,161,4,254,544,9,5,2,3
JetBrains/intellij-community,162,1,17,2,1,1,0,1
JetBrains/intellij-community,164,1,213,374,1,1,0,1
JetBrains/intellij-community,170,1,119,131,2,2,0,2
JetBrains/intellij-community,172,1,11,33,1,1,0,1
JetBrains/intellij-community,178,1,45,122,16,1,1,0
JetBrains/intellij-community,180,7,421,680,15,9,1,8
JetBrains/intellij-community,186,1,81,177,7,2,1,1
JetBrains/intellij-community,191,1,113,281,1,1,0,1
JetBrains/intellij-community,192,3,118,266,5,4,1,3
JetBrains/intellij-community,193,1,63,110,5,2,1,1
JetBrains/intellij-community,196,1,5,3,0,0,0,0
JetBrains/intellij-community,197,3,68,43,14,10,2,8
JetBrains/intellij-community,198,1,257,622,1,1,0,1
JetBrains/intellij-community,200,1,24,60,2,2,0,2
JetBrains/intellij-community,203,1,401,791,8,5,1,4
JetBrains/intellij-community,207,3,270,469,9,3,1,2
JetBrains/intellij-community,211,1,46,89,2,1,0,1
JetBrains/intellij-community,212,1,129,261,2,1,1,0
JetBrains/intellij-community,213,1,36,86,1,1,0,1
JetBrains/intellij-community,217,1,159,381,1,1,0,1
JetBrains/intellij-community,220,2,22,31,8,8,0,8
JetBrains/intellij-community,221,2,22,31,8,8,0,8
JetBrains/intellij-community,223,1,28,47,2,2,0,2
JetBrains/intellij-community,234,2,91,238,30,3,1,2
JetBrains/intellij-community,235,1,227,907,3,1,0,1
JetBrains/intellij-community,241,1,236,339,4,2,2,0
JetBrains/intellij-community,242,2,366,721,4,2,1,1
JetBrains/intellij-community,250,1,16,18,4,3,1,2
JetBrains/intellij-community,254,5,48,43,17,15,2,13
JetBrains/intellij-community,256,2,145,218,10,7,0,7
JetBrains/intellij-community,257,1,106,183,4,2,1,1
JetBrains/intellij-community,261,3,87,164,0,0,0,0
JetBrains/intellij-community,262,1,17,24,11,4,1,3
JetBrains/intellij-community,265,1,44,83,7,1,0,1
JetBrains/intellij-community,267,1,186,226,1,1,0,1
JetBrains/intellij-community,268,1,105,293,1,1,0,1
JetBrains/intellij-community,270,1,32,55,0,0,0,0
JetBrains/intellij-community,274,1,56,82,4,4,0,4
JetBrains/intellij-community,275,1,56,82,2,2,0,2
JetBrains/intellij-community,279,1,5,3,3,3,0,3
JetBrains/intellij-community,281,1,13,23,7,3,1,2
junit-team/junit,1017,6,198,276,28,13,1,12
junit-team/junit,1018,5,181,256,21,9,1,8
junit-team/junit,1020,2,163,183,18,11,2,9
junit-team/junit,1021,1,36,44,2,2,0,2
junit-team/junit,1025,1,109,48,0,0,0,0
junit-team/junit,1027,1,109,48,0,0,0,0
junit-team/junit,1028,7,240,371,97,36,3,33
junit-team/junit,1031,1,237,275,4,2,2,0
junit-team/junit,1033,1,15,0,8,8,0,8
junit-team/junit,1037,2,149,177,20,12,3,9
junit-team/junit,1041,1,2,0,9,9,0,9
junit-team/junit,1044,4,110,115,39,21,3,18
junit-team/junit,1047,2,15,12,0,0,0,0
junit-team/junit,1048,3,10,5,5,3,1,2
junit-team/junit,1049,12,253,352,0,0,0,0
junit-team/junit,1054,2,187,144,8,4,1,3
junit-team/junit,1055,3,424,570,20,9,1,8
junit-team/junit,1060,1,100,74,1,1,0,1
junit-team/junit,1061,1,101,146,1,1,0,1
junit-team/junit,1062,1,50,64,1,1,0,1
junit-team/junit,1063,14,268,364,0,0,0,0
junit-team/junit,1065,4,78,80,24,11,2,9
junit-team/junit,1068,1,13,8,2,2,0,2
junit-team/junit,1071,1,101,146,2,1,0,1
junit-team/junit,1072,5,118,155,26,11,1,10
junit-team/junit,1082,3,127,167,21,14,2,12
junit-team/junit,1085,2,59,70,2,2,0,2
junit-team/junit,1086,1,3,1,1,1,0,1
junit-team/junit,1087,1,40,42,1,1,0,1
junit-team/junit,1091,2,190,108,20,17,0,17
junit-team/junit,1093,2,198,108,26,20,0,20
junit-team/junit,1096,7,402,511,9,9,0,9
junit-team/junit,1097,3,102,90,11,6,1,5
junit-team/junit,1098,2,258,288,2,2,0,2
junit-team/junit,1105,1,5,0,0,0,0,0
junit-team/junit,1107,10,361,380,100,40,3,37
junit-team/junit,1111,1,45,41,1,1,0,1
junit-team/junit,1112,1,45,41,1,1,0,1
junit-team/junit,1116,1,5,3,4,2,1,1
junit-team/junit,1117,4,271,400,16,5,1,4
junit-team/junit,1120,10,186,222,49,30,2,28
junit-team/junit,1121,1,37,67,5,1,1,0
junit-team/junit,1122,10,186,222,48,29,2,27
junit-team/junit,1128,1,6,1,1,1,0,1
junit-team/junit,1129,1,14,15,2,2,0,2
junit-team/junit,1130,22,565,583,215,92,5,87
junit-team/junit,1131,2,130,103,22,14,1,13
junit-team/junit,1134,9,380,506,66,51,2,49
junit-team/junit,1137,7,489,655,30,19,1,18
junit-team/junit,1143,1,5,0,1,1,0,1
junit-team/junit,1149,2,2,0,3,3,0,3
junit-team/junit,1150,8,331,358,26,26,0,26
junit-team/junit,1152,1,18,38,1,1,0,1
junit-team/junit,1153,2,479,626,44,7,1,6
junit-team/junit,1154,2,423,577,20,9,2,7
junit-team/junit,1155,1,70,104,1,1,0,1
junit-team/junit,1156,1,213,112,0,0,0,0
junit-team/junit,1157,1,5,3,1,1,0,1
junit-team/junit,1158,6,52,53,26,5,2,3
junit-team/junit,1163,1,6,1,1,1,0,1
junit-team/junit,1174,1,15,9,2,2,0,2
junit-team/junit,1057,4,307,391,6,6,0,6
junit-team/junit,1140,1,11,12,2,2,0,2
libgdx/libgdx,3174,1,109,267,3,1,1,0
libgdx/libgdx,3175,2,105,199,11,4,2,2
libgdx/libgdx,3176,1,72,145,8,2,1,1
libgdx/libgdx,3177,1,54,98,15,5,1,4
libgdx/libgdx,3183,3,587,2491,11,3,0,3
libgdx/libgdx,3184,1,209,747,1,1,0,1
libgdx/libgdx,3185,1,108,268,2,1,0,1
libgdx/libgdx,3191,1,35,55,1,1,0,1
libgdx/libgdx,3196,1,53,130,3,1,0,1
libgdx/libgdx,3199,1,79,216,3,1,0,1
libgdx/libgdx,3209,10,218,460,75,20,1,19
libgdx/libgdx,3215,1,183,360,1,1,0,1
libgdx/libgdx,3217,1,175,549,2,1,0,1
libgdx/libgdx,3220,1,142,233,2,1,1,0
libgdx/libgdx,3222,2,425,1022,3,1,1,0
libgdx/libgdx,3224,1,438,732,16,7,1,6
libgdx/libgdx,3228,3,565,1776,7,7,0,7
libgdx/libgdx,3231,4,156,222,28,24,4,20
libgdx/libgdx,3233,1,58,56,6,6,0,6
libgdx/libgdx,3234,1,111,396,2,2,0,2
libgdx/libgdx,3236,22,3333,7810,75,34,11,23
libgdx/libgdx,3247,1,393,798,2,2,0,2
libgdx/libgdx,3248,1,114,271,1,1,0,1
libgdx/libgdx,3121,1,182,343,2,2,0,2
libgdx/libgdx,3123,1,482,1699,4,2,0,2
libgdx/libgdx,3125,4,193,360,14,9,2,7
libgdx/libgdx,3128,3,240,436,43,13,2,11
libgdx/libgdx,3129,1,130,230,6,2,1,1
libgdx/libgdx,3132,3,226,392,44,16,2,14
libgdx/libgdx,3136,1,124,209,2,1,0,1
libgdx/libgdx,3139,1,53,103,1,1,0,1
libgdx/libgdx,3140,4,352,692,52,15,2,13
libgdx/libgdx,3142,9,302,244,22,16,1,15
libgdx/libgdx,3149,1,137,567,1,1,0,1
libgdx/libgdx,3150,1,108,129,3,2,1,1
libgdx/libgdx,3151,1,68,127,1,1,0,1
libgdx/libgdx,3152,1,68,127,1,1,0,1
libgdx/libgdx,3154,1,34,53,1,1,0,1
libgdx/libgdx,3155,1,90,119,0,0,0,0
libgdx/libgdx,3159,1,79,214,2,2,0,2
libgdx/libgdx,3160,1,110,269,3,3,0,3
libgdx/libgdx,3161,2,154,311,6,4,0,4
libgdx/libgdx,3162,1,84,203,7,2,1,1
libgdx/libgdx,3167,1,184,706,6,2,1,1
libgdx/libgdx,3055,2,233,566,6,2,1,1
libgdx/libgdx,3056,2,145,177,4,4,0,4
libgdx/libgdx,3059,6,247,547,35,11,2,9
libgdx/libgdx,3064,1,65,47,1,1,0,1
libgdx/libgdx,3069,2,452,780,24,10,2,8
libgdx/libgdx,3071,5,1252,3754,30,13,2,11
libgdx/libgdx,3077,2,195,354,20,14,1,13
libgdx/libgdx,3081,2,193,352,20,15,2,13
libgdx/libgdx,3083,1,330,828,3,2,0,2
libgdx/libgdx,3088,1,25,28,3,2,1,1
libgdx/libgdx,3089,1,194,371,3,1,1,0
libgdx/libgdx,3097,1,145,227,1,1,0,1
libgdx/libgdx,3102,1,202,632,2,2,0,2
libgdx/libgdx,3108,1,65,47,1,1,0,1
libgdx/libgdx,3109,1,65,47,4,4,0,4
libgdx/libgdx,3110,21,1833,2168,24,24,0,24
libgdx/libgdx,3117,2,102,252,2,2,0,2
libgdx/libgdx,3119,1,65,47,1,1,0,1
libgdx/libgdx,3169,1,15,14,2,2,0,2
mockito/mockito,170,2,27,17,5,5,0,5
mockito/mockito,32,3,35,106,8,6,1,5
mockito/mockito,100,1,75,20,30,30,0,30
mockito/mockito,102,10,87,63,53,24,2,22
mockito/mockito,103,2,57,56,20,12,1,11
mockito/mockito,106,12,559,519,86,48,7,41
mockito/mockito,113,2,28,30,5,4,0,4
mockito/mockito,116,3,249,206,30,22,1,21
mockito/mockito,121,2,38,28,10,7,1,6
mockito/mockito,126,4,108,127,36,17,2,15
mockito/mockito,138,2,186,387,5,5,0,5
mockito/mockito,141,9,619,975,74,19,1,18
mockito/mockito,142,2,69,64,9,8,1,7
mockito/mockito,144,3,17,21,7,4,1,3
mockito/mockito,149,1,71,7,21,21,0,21
mockito/mockito,162,2,80,120,28,5,1,4
mockito/mockito,163,2,80,122,29,5,1,4
mockito/mockito,167,12,291,426,92,38,2,36
mockito/mockito,18,1,57,59,3,3,0,3
mockito/mockito,180,1,24,23,1,1,0,1
mockito/mockito,192,2,18,41,9,7,1,6
mockito/mockito,20,6,174,247,16,12,2,10
mockito/mockito,201,2,81,103,8,7,0,7
mockito/mockito,202,11,489,531,122,84,3,81
mockito/mockito,207,8,295,284,38,20,4,16
mockito/mockito,21,2,20,23,2,2,0,2
mockito/mockito,211,6,126,173,41,23,2,21
mockito/mockito,22,1,3,0,2,2,0,2
mockito/mockito,223,1,148,150,1,1,0,1
mockito/mockito,229,1,1,0,1,1,0,1
mockito/mockito,234,4,25,30,13,11,1,10
mockito/mockito,235,4,106,90,38,31,4,27
mockito/mockito,238,13,656,732,46,32,1,31
mockito/mockito,24,4,118,155,36,14,1,13
mockito/mockito,240,3,210,226,9,3,1,2
mockito/mockito,242,10,297,300,30,27,0,27
mockito/mockito,26,1,67,55,2,2,0,2
mockito/mockito,29,2,95,123,14,8,2,6
mockito/mockito,30,5,241,392,26,19,2,17
mockito/mockito,33,5,86,101,14,12,1,11
mockito/mockito,36,3,80,92,6,6,0,6
mockito/mockito,37,10,464,541,12,12,0,12
mockito/mockito,39,8,301,338,27,19,2,17
mockito/mockito,41,4,95,102,8,8,0,8
mockito/mockito,45,4,85,122,25,13,1,12
mockito/mockito,46,3,72,118,13,5,1,4
mockito/mockito,47,2,22,44,5,4,1,3
mockito/mockito,49,4,65,111,6,4,1,3
mockito/mockito,52,5,137,153,9,9,0,9
mockito/mockito,54,6,114,100,22,16,3,13
mockito/mockito,55,3,108,101,27,24,1,23
mockito/mockito,56,1,7,3,1,1,0,1
mockito/mockito,59,6,174,388,12,8,0,8
mockito/mockito,60,3,29,22,15,9,1,8
mockito/mockito,61,1,22,40,2,2,0,2
mockito/mockito,63,3,270,263,15,12,1,11
mockito/mockito,65,3,83,87,16,5,1,4
mockito/mockito,66,5,92,126,26,7,1,6
mockito/mockito,79,1,23,14,9,5,1,4
mockito/mockito,81,64,3422,10152,931,110,3,107
mockito/mockito,82,2,12,7,7,4,1,3
mockito/mockito,85,7,120,98,45,21,1,20
mockito/mockito,87,2,31,39,17,8,1,7
nathanmarz/storm,693,3,351,227,4,1,1,0
nathanmarz/storm,694,1,284,101,1,1,0,1
nathanmarz/storm,695,1,15,19,2,2,0,2
nathanmarz/storm,701,1,33,57,2,2,0,2
nathanmarz/storm,705,1,286,101,1,1,0,1
nathanmarz/storm,713,1,40,82,2,1,0,1
nathanmarz/storm,715,1,156,238,6,3,0,3
nathanmarz/storm,719,1,39,69,1,1,0,1
nathanmarz/storm,725,1,31,36,4,2,0,2
nathanmarz/storm,726,1,40,78,24,6,2,4
nathanmarz/storm,727,1,41,86,2,2,0,2
nathanmarz/storm,730,2,350,223,3,2,1,1
nathanmarz/storm,731,9,324,363,61,18,1,17
nathanmarz/storm,733,1,286,101,1,1,0,1
nathanmarz/storm,740,2,313,138,3,1,1,0
nathanmarz/storm,741,7,4663,9378,182,12,5,7
nathanmarz/storm,748,5,328,669,49,10,2,8
nathanmarz/storm,749,1,290,101,1,1,0,1
nathanmarz/storm,750,4,4150,7464,117,22,7,15
nathanmarz/storm,765,1,288,101,1,1,0,1
nathanmarz/storm,766,8,189,349,11,11,0,11
nathanmarz/storm,781,2,108,207,4,4,0,4
nathanmarz/storm,518,5,211,142,22,14,2,12
nathanmarz/storm,519,3,33,22,3,3,0,3
nathanmarz/storm,520,1,16,0,1,1,0,1
nathanmarz/storm,521,2,17,22,2,2,0,2
nathanmarz/storm,524,2,52,37,8,5,1,4
nathanmarz/storm,528,1,59,116,15,9,0,9
nathanmarz/storm,532,1,21,27,5,5,0,5
nathanmarz/storm,545,2,305,416,4,3,1,2
nathanmarz/storm,555,2,350,224,3,2,1,1
nathanmarz/storm,556,12,378,473,76,16,1,15
nathanmarz/storm,561,1,36,55,1,1,0,1
nathanmarz/storm,563,1,17,38,5,1,1,0
nathanmarz/storm,564,1,37,64,3,3,0,3
nathanmarz/storm,566,2,190,301,4,3,1,2
nathanmarz/storm,570,1,171,101,95,95,0,95
nathanmarz/storm,582,1,26,41,7,3,1,2
nathanmarz/storm,584,16,860,1066,149,57,4,53
nathanmarz/storm,592,2,105,194,12,5,2,3
nathanmarz/storm,598,1,176,101,1,1,0,1
nathanmarz/storm,609,1,176,101,1,1,0,1
nathanmarz/storm,621,2,17,0,3,3,0,3
nathanmarz/storm,622,3,186,274,11,5,1,4
nathanmarz/storm,625,4,212,267,15,9,1,8
nathanmarz/storm,626,1,73,135,3,2,1,1
nathanmarz/storm,629,4,346,229,17,5,1,4
nathanmarz/storm,631,1,18,17,7,3,0,3
nathanmarz/storm,632,1,280,101,1,1,0,1
nathanmarz/storm,633,3,50,74,15,7,2,5
nathanmarz/storm,634,2,299,130,3,2,1,1
nathanmarz/storm,635,1,15,19,5,3,1,2
nathanmarz/storm,636,1,21,15,4,2,0,2
nathanmarz/storm,648,1,35,34,0,0,0,0
nathanmarz/storm,650,2,15,0,3,3,0,3
nathanmarz/storm,660,1,280,101,1,1,0,1
nathanmarz/storm,663,1,49,90,9,6,1,5
nathanmarz/storm,664,1,152,217,3,2,0,2
nathanmarz/storm,682,1,24,28,3,3,0,3
nathanmarz/storm,686,2,94,158,2,2,0,2
nathanmarz/storm,583,2,295,129,113,100,1,99
nathanmarz/storm,691,1,37,64,1,1,0,1
netty/netty,3739,1,204,351,9,1,1,0
netty/netty,3811,1,67,199,1,1,0,1
netty/netty,3816,1,180,308,9,3,1,2
netty/netty,3819,1,24,22,8,3,0,3
netty/netty,3821,1,66,77,2,1,0,1
netty/netty,3822,1,81,167,10,1,1,0
netty/netty,3825,1,40,65,1,1,0,1
netty/netty,3826,1,83,164,2,1,0,1
netty/netty,3827,4,441,662,32,18,1,17
netty/netty,3828,9,336,1322,99,13,1,12
netty/netty,3829,4,592,1148,11,3,2,1
netty/netty,3830,1,102,116,1,1,0,1
netty/netty,3831,1,26,28,5,2,0,2
netty/netty,3832,5,581,631,18,12,2,10
netty/netty,3834,2,226,299,15,7,1,6
netty/netty,3839,7,651,883,52,6,1,5
netty/netty,3841,2,178,849,7,3,1,2
netty/netty,3847,2,104,318,43,13,2,11
netty/netty,3851,1,72,74,1,1,0,1
netty/netty,3866,2,532,590,5,1,1,0
netty/netty,3867,1,132,371,2,1,0,1
netty/netty,3869,2,161,368,5,4,1,3
netty/netty,3870,1,310,0,5,5,0,5
netty/netty,3875,2,127,179,6,5,1,4
netty/netty,3878,1,66,77,1,1,0,1
netty/netty,3889,1,308,748,2,2,0,2
netty/netty,3891,1,104,171,4,2,1,1
netty/netty,3893,1,327,812,68,2,1,1
netty/netty,3901,15,416,595,146,102,4,98
netty/netty,3903,3,123,135,46,24,2,22
netty/netty,3906,24,384,594,73,57,4,53
netty/netty,3912,1,24,53,1,1,0,1
netty/netty,3917,2,279,517,9,9,0,9
netty/netty,3923,1,58,115,1,1,0,1
netty/netty,3926,2,69,257,26,3,1,2
netty/netty,3716,1,16,27,1,1,0,1
netty/netty,3723,5,403,807,29,8,3,5
netty/netty,3729,3,387,842,4,3,0,3
netty/netty,3730,4,640,800,21,11,2,9
netty/netty,3734,1,314,514,2,2,0,2
netty/netty,3742,1,73,133,7,2,1,1
netty/netty,3743,3,44,25,12,10,2,8
netty/netty,3744,2,33,33,7,4,0,4
netty/netty,3745,1,65,127,1,1,0,1
netty/netty,3754,26,754,2188,283,79,6,73
netty/netty,3763,9,416,1213,29,14,3,11
netty/netty,3764,1,100,302,1,1,0,1
netty/netty,3766,1,51,155,7,1,0,1
netty/netty,3767,4,55,100,4,4,0,4
netty/netty,3771,3,301,643,4,3,0,3
netty/netty,3772,3,221,576,4,3,0,3
netty/netty,3773,2,118,267,27,3,1,2
netty/netty,3776,2,286,305,4,4,0,4
netty/netty,3777,2,44,90,3,2,1,1
netty/netty,3789,7,409,752,18,13,1,12
netty/netty,3790,1,310,0,1,1,0,1
netty/netty,3792,1,113,182,5,3,1,2
netty/netty,3794,3,415,926,16,10,2,8
netty/netty,3795,5,453,740,33,14,3,11
netty/netty,3802,13,824,1217,158,109,8,101
netty/netty,3808,1,41,66,5,1,1,0
netty/netty,3809,1,81,131,1,1,0,1
openhab/openhab,2670,3,81,234,25,7,2,5
openhab/openhab,2672,1,52,76,1,1,0,1
openhab/openhab,2683,1,62,141,2,2,0,2
openhab/openhab,2684,1,62,141,2,2,0,2
openhab/openhab,2698,2,48,114,5,3,1,2
openhab/openhab,2701,1,42,152,1,1,0,1
openhab/openhab,2703,2,118,199,9,4,1,3
openhab/openhab,2707,6,188,259,79,10,2,8
openhab/openhab,2713,1,163,438,3,3,0,3
openhab/openhab,2714,9,608,1801,34,11,2,9
openhab/openhab,2715,2,112,186,6,2,2,0
openhab/openhab,2717,1,79,128,1,1,0,1
openhab/openhab,2724,9,215,314,24,8,1,7
openhab/openhab,2726,1,55,128,1,1,0,1
openhab/openhab,2728,2,118,199,9,4,1,3
openhab/openhab,2729,3,185,401,52,18,2,16
openhab/openhab,2733,2,173,343,26,6,1,5
openhab/openhab,2735,1,62,203,8,1,1,0
openhab/openhab,2736,1,67,109,1,1,0,1
openhab/openhab,2738,1,196,173,3,1,0,1
openhab/openhab,2752,1,92,339,1,1,0,1
openhab/openhab,2753,1,196,173,6,1,0,1
openhab/openhab,2678,1,60,91,3,1,0,1
openhab/openhab,2755,8,293,574,46,17,4,13
openhab/openhab,2759,1,88,198,1,1,0,1
openhab/openhab,2760,1,26,60,5,4,1,3
openhab/openhab,2763,1,128,366,1,1,0,1
openhab/openhab,2764,1,95,346,5,3,1,2
openhab/openhab,2765,1,163,441,1,1,0,1
openhab/openhab,2767,1,25,94,2,2,0,2
openhab/openhab,2770,1,95,14,1,1,0,1
openhab/openhab,2774,1,80,278,1,1,0,1
openhab/openhab,2779,1,92,349,13,3,1,2
openhab/openhab,2780,1,41,129,1,1,0,1
openhab/openhab,2781,1,95,356,11,5,1,4
openhab/openhab,2782,6,754,1426,46,10,3,7
openhab/openhab,2784,18,387,854,136,42,2,40
openhab/openhab,2786,1,26,26,2,2,0,2
openhab/openhab,2788,3,103,262,17,7,2,5
openhab/openhab,2790,2,117,237,2,1,1,0
openhab/openhab,2793,1,33,39,3,2,1,1
openhab/openhab,2794,3,70,186,4,3,0,3
openhab/openhab,2795,1,6,3,2,1,0,1
openhab/openhab,2796,1,160,390,12,2,0,2
openhab/openhab,2797,8,441,1282,46,8,1,7
openhab/openhab,2800,1,26,59,1,1,0,1
openhab/openhab,2802,2,88,175,12,6,1,5
openhab/openhab,2805,2,145,621,30,3,1,2
openhab/openhab,2808,1,79,127,0,0,0,0
openhab/openhab,2810,1,99,540,1,1,0,1
openhab/openhab,2815,1,96,242,4,1,1,0
openhab/openhab,2818,1,180,308,3,2,1,1
openhab/openhab,2820,5,293,555,25,7,1,6
openhab/openhab,2824,1,92,349,13,3,1,2
openhab/openhab,2825,1,6,4,1,1,0,1
openhab/openhab,2829,1,6,4,1,1,0,1
openhab/openhab,2831,1,92,349,13,3,1,2
openhab/openhab,2832,25,629,1338,296,82,15,67
openhab/openhab,2833,1,95,364,13,5,1,4
openhab/openhab,2834,1,63,201,7,1,1,0
openhab/openhab,2835,2,82,124,17,6,1,5
openhab/openhab,2840,1,96,185,2,1,0,1
spring-projects/spring-framework,724,4,96,130,17,9,2,7
spring-projects/spring-framework,765,3,125,211,8,8,0,8
spring-projects/spring-framework,726,3,45,47,24,5,2,3
spring-projects/spring-framework,729,3,45,47,24,5,2,3
spring-projects/spring-framework,730,1,1,0,2,2,0,2
spring-projects/spring-framework,731,1,44,102,3,3,0,3
spring-projects/spring-framework,732,1,48,111,3,1,1,0
spring-projects/spring-framework,735,1,223,432,2,2,0,2
spring-projects/spring-framework,736,1,176,317,2,2,0,2
spring-projects/spring-framework,738,1,97,215,1,1,0,1
spring-projects/spring-framework,739,1,114,281,3,2,0,2
spring-projects/spring-framework,743,4,197,529,22,11,2,9
spring-projects/spring-framework,744,1,111,205,3,2,1,1
spring-projects/spring-framework,745,2,107,216,19,10,1,9
spring-projects/spring-framework,746,1,85,131,1,1,0,1
spring-projects/spring-framework,747,2,125,227,4,3,0,3
spring-projects/spring-framework,748,1,120,212,1,1,0,1
spring-projects/spring-framework,750,4,314,545,21,12,2,10
spring-projects/spring-framework,752,1,163,392,1,1,0,1
spring-projects/spring-framework,753,2,123,121,5,5,0,5
spring-projects/spring-framework,756,1,59,99,5,4,1,3
spring-projects/spring-framework,757,1,17,21,2,1,1,0
spring-projects/spring-framework,758,1,64,147,2,1,1,0
spring-projects/spring-framework,759,5,605,1269,32,15,2,13
spring-projects/spring-framework,762,2,239,527,11,7,1,6
spring-projects/spring-framework,763,5,292,707,19,12,3,9
spring-projects/spring-framework,766,1,1,0,1,1,0,1
spring-projects/spring-framework,768,2,33,53,10,5,1,4
spring-projects/spring-framework,772,14,161,196,62,23,2,21
spring-projects/spring-framework,773,1,67,208,1,1,0,1
spring-projects/spring-framework,775,2,372,920,4,3,1,2
spring-projects/spring-framework,777,1,2,0,2,2,0,2
spring-projects/spring-framework,778,1,235,495,4,3,0,3
spring-projects/spring-framework,782,2,255,652,9,3,1,2
spring-projects/spring-framework,794,2,58,75,22,5,2,3
spring-projects/spring-framework,795,4,332,1421,5,4,0,4
spring-projects/spring-framework,797,3,70,66,7,5,0,5
spring-projects/spring-framework,799,2,278,369,13,5,2,3
spring-projects/spring-framework,800,10,142,167,44,17,2,15
spring-projects/spring-framework,801,1,61,144,3,1,0,1
spring-projects/spring-framework,802,1,36,74,1,1,0,1
spring-projects/spring-framework,804,2,334,926,12,2,1,1
spring-projects/spring-framework,808,3,122,291,4,3,1,2
spring-projects/spring-framework,810,2,372,918,3,2,1,1
spring-projects/spring-framework,811,1,22,7,1,1,0,1
spring-projects/spring-framework,812,1,185,330,4,4,0,4
spring-projects/spring-framework,814,1,3,0,1,1,0,1
spring-projects/spring-framework,815,2,75,173,8,3,1,2
spring-projects/spring-framework,816,5,361,520,48,9,1,8
spring-projects/spring-framework,817,1,74,105,2,1,0,1
spring-projects/spring-framework,819,2,181,1152,2,2,0,2
spring-projects/spring-framework,822,1,8,9,1,1,0,1
spring-projects/spring-framework,825,26,692,1257,301,64,8,56
spring-projects/spring-framework,829,1,52,75,1,1,0,1
spring-projects/spring-framework,708,1,9,0,2,2,0,2
spring-projects/spring-framework,709,1,11,11,1,1,0,1
spring-projects/spring-framework,712,2,100,201,7,2,1,1
spring-projects/spring-framework,715,5,205,706,48,10,3,7
spring-projects/spring-framework,716,1,52,106,1,1,0,1
spring-projects/spring-framework,717,1,38,51,1,1,0,1
spring-projects/spring-framework,721,1,6,0,2,1,0,1
spring-projects/spring-framework,723,2,62,102,7,5,1,4
voldemort/voldemort,199,1,94,237,4,4,0,4
voldemort/voldemort,250,1,75,169,1,1,0,1
voldemort/voldemort,122,5,1030,1601,49,19,3,16
voldemort/voldemort,123,1,39,68,1,1,0,1
voldemort/voldemort,126,1,19,25,2,2,0,2
voldemort/voldemort,137,6,138,174,13,13,0,13
voldemort/voldemort,141,1,107,294,4,1,1,0
voldemort/voldemort,146,2,36,34,2,1,1,0
voldemort/voldemort,147,1,161,452,9,2,1,1
voldemort/voldemort,154,1,15,18,1,1,0,1
voldemort/voldemort,158,2,40,51,7,3,1,2
voldemort/voldemort,160,2,123,243,18,5,1,4
voldemort/voldemort,163,1,22,30,4,1,1,0
voldemort/voldemort,169,1,23,48,1,1,0,1
voldemort/voldemort,170,4,372,1162,20,6,1,5
voldemort/voldemort,172,2,92,230,20,2,1,1
voldemort/voldemort,180,1,50,69,4,3,1,2
voldemort/voldemort,182,1,42,58,1,1,0,1
voldemort/voldemort,186,1,15,18,1,1,0,1
voldemort/voldemort,188,3,130,195,8,6,1,5
voldemort/voldemort,190,2,380,887,31,10,0,10
voldemort/voldemort,196,1,181,524,2,2,0,2
voldemort/voldemort,197,1,140,389,2,2,0,2
voldemort/voldemort,198,1,181,524,1,1,0,1
voldemort/voldemort,200,2,208,488,3,3,0,3
voldemort/voldemort,201,3,670,915,16,7,1,6
voldemort/voldemort,207,1,30,67,6,2,0,2
voldemort/voldemort,210,1,74,68,13,6,0,6
voldemort/voldemort,213,1,16,17,11,5,1,4
voldemort/voldemort,215,2,157,264,4,3,1,2
voldemort/voldemort,218,2,176,213,28,14,3,11
voldemort/voldemort,221,27,1361,2447,234,48,6,42
voldemort/voldemort,224,1,214,543,10,1,1,0
voldemort/voldemort,227,1,94,215,2,1,0,1
voldemort/voldemort,228,1,94,217,2,1,0,1
voldemort/voldemort,230,2,132,269,6,2,1,1
voldemort/voldemort,231,10,1381,2468,56,18,4,14
voldemort/voldemort,233,2,69,178,15,4,1,3
voldemort/voldemort,235,1,106,299,1,1,0,1
voldemort/voldemort,239,2,338,843,2,2,0,2
voldemort/voldemort,240,11,674,1529,39,17,3,14
voldemort/voldemort,242,21,2323,4835,81,33,3,30
voldemort/voldemort,243,21,2323,4835,81,33,3,30
voldemort/voldemort,245,7,634,1354,39,18,3,15
voldemort/voldemort,246,1,161,445,7,1,1,0
voldemort/voldemort,249,22,1000,1754,128,83,4,79
voldemort/voldemort,261,6,1058,1833,59,12,4,8
voldemort/voldemort,265,1,52,51,1,1,0,1
voldemort/voldemort,266,11,609,968,110,66,1,65
voldemort/voldemort,267,1,17,39,8,1,0,1
voldemort/voldemort,269,1,667,910,1,1,0,1
voldemort/voldemort,270,2,295,710,18,1,1,0
voldemort/voldemort,273,1,61,124,2,1,0,1
voldemort/voldemort,276,6,658,1700,37,9,2,7
voldemort/voldemort,277,1,38,67,8,2,1,1
voldemort/voldemort,76,1,80,167,1,1,0,1
voldemort/voldemort,79,1,104,250,2,2,0,2
voldemort/voldemort,81,9,802,1383,57,20,1,19
voldemort/voldemort,84,1,52,116,1,1,0,1
voldemort/voldemort,85,1,98,155,1,1,0,1
voldemort/voldemort,88,1,97,210,4,2,0,2
voldemort/voldemort,92,2,36,34,2,1,1,0
